#domain
hospital
#levelname
KatogRas_gennemgang_2CB
#colors
red: 0, A
green: 1, B
cyan: 2, C
#initial
++++++++++++
+  0     + +
+ ++++++++A+
+       BC +
++++ +++++ +
+1     2 B +
++++++     +
++++++++++++
#goal
++++++++++++
+        +A+
+ ++++++++ +
+   B      +
++++ +++++ +
+          +
++++++     +
++++++++++++
#end
