#domain
hospital
#levelname
KatogRas_ny_svaer
#colors
red: 0, A
green: 1, B
cyan: 2, C
#initial
++++++++++++
+  0     + +
+ ++++++++A+
+        B +
++++++++++ +
+1      CB +
+ 2      CB+
++++++++++++
#goal
++++++++++++
+        +A+
+ ++++++++ +
+   B      +
++++++++++ +
+          +
+   C      +
++++++++++++
#end
